###############################
*-----------------------#######
#-----------------------#######
######################--#######
######################--#######
######################--#######
######################--#######
######################--#######
######################--#######
######################--#######
######################--####@##
######################--------#
######################--------#
######################--------#
###############################