###############################
*-----------------------#######
#-----------------------#######
##########-###########--#######
##########-###########--#######
##########-###########--#######
##########-###########--#######
##########-###########--#######
##########-###########--#######
#########---##########--#######
#########---##########--####@##
#########---##########--------#
######################--------#
######################--------#
###############################